10 10 21 10
0 0 0 0 0 0 0 0 -1 0
0 -1 -1 0 0 -1 0 0 -1 0
0 0 0 -1 S 0 0 0 -1 0
0 0 -1 0 0 0 -1 0 -1 0
0 0 0 0 -1 0 0 0 0 0
0 -1 0 0 0 -1 0 0 0 0
0 0 0 -1 -1 0 0 0 0 0
0 0 0 0 0 0 -1 -1 -1 0
0 -1 -1 -1 0 0 0 0 0 0
0 0 0 -1 0 0 0 0 G 0