11 14 37 26
S1 0 0 0 0 0 0 -1 -1 0 0 0 G1 0
0 -1 -1 -1 -1 0 S2 0 -1 -1 -1 7 0 0
0 0 0 1 0 0 0 0 0 0 -1 0 0 0
0 -1 -1 0 -1 -1 -1 0 6 0 -1 0 0 0
2 0 0 0 0 5 -1 -1 0 0 -1 0 -1 0
0 -1 -1 -1 0 0 0 0 F2 0 -1 0 0 0
0 0 0 -1 -1 0 -1 -1 0 0 -1 0 -1 0
0 0 -1 -1 0 0 0 -1 -1 0 -1 0 -1 0
0 0 0 0 0 -1 0 -1 0 0 -1 0 -1 G2
0 -1 -1 -1 0 -1 0 F1 0 0 -1 0 -1 0
0 0 1 0 0 -1 -1 0 0 0 0 0 -1 0