15 12 30 17
0 0 0 0 G1 0 0 0 0 0 0 0
0 -1 -1 0 0 0 0 -1 -1 0 S2 0
S3 0 0 -1 0 9 0 0 -1 -1 0 0
-1 -1 0 0 0 0 F3 7 0 0 0 0
0 0 0 0 0 0 -1 -1 -1 0 0 -1
0 -1 -1 0 0 -1 0 0 0 0 0 -1
-1 -1 0 0 8 0 0 0 -1 0 0 -1
0 0 0 0 0 -1 0 -1 0 0 -1 -1
0 0 F1 -1 F2 0 0 -1 0 0 0 -1
0 0 0 0 0 0 0 -1 -1 0 0 0
-1 -1 0 0 -1 0 0 0 0 0 G3 0
0 0 -1 4 -1 2 6 -1 -1 0 0 0
-1 -1 0 0 0 0 0 0 0 8 0 0
0 0 0 0 -1 -1 -1 0 0 0 0 0
-1 -1 0 G2 0 0 0 0 0 S1 0 0