19 9 41 22
0 0 0 0 0 0 -1 -1 -1
S1 0 -1 -1 -1 0 0 G2 -1
0 0 0 0 -1 0 0 0 0
-1 -1 -1 2 -1 -1 -1 0 0
0 0 0 0 0 0 -1 0 -1
0 -1 -1 -1 0 4 0 0 -1
0 0 0 -1 -1 0 0 -1 -1
0 0 F2 -1 0 0 10 -1 0
-1 0 0 0 0 -1 0 -1 0
-1 -1 -1 3 0 -1 0 0 0
0 0 0 0 0 -1 -1 0 0
0 -1 -1 -1 0 0 0 0 -1
7 0 0 0 0 -1 -1 0 0
0 -1 -1 -1 F1 0 -1 -1 0
0 0 0 0 0 -1 -1 0 0 
0 -1 -1 -1 0 9 -1 0 0
0 0 0 -1 -1 0 0 0 0
-1 -1 0 0 0 0 -1 0 -1
0 0 0 S2 0 -1 -1 0 G1