10 10 17
0 0 0 0 0 0 8 0 -1 0
0 -1 -1 0 0 -1 0 0 -1 0
0 0 0 -1 S 0 0 0 -1 0
0 0 -1 0 0 0 -1 0 -1 0
2 0 0 0 -1 0 0 0 0 0
0 -1 0 0 0 -1 0 6 0 0
0 0 0 -1 -1 0 5 0 0 0
0 0 0 0 0 0 -1 -1 -1 0
0 -1 -1 -1 0 0 0 0 0 0
0 0 0 -1 0 0 0 7 G 0