10 10 16
0 0 -1 0 0 -1 0 0 0 0
0 -1 S 0 0 -1 0 0 -1 0
0 -1 0 0 1 0 0 0 -1 0
0 0 0 0 0 7 0 0 -1 0
0 4 0 0 -1 0 2 0 -1 0
0 -1 0 0 0 -1 9 0 0 0
0 0 0 -1 -1 -1 0 0 0 0
0 0 0 -1 0 0 0 0 -1 0
0 -1 -1 -1 0 0 G 0 0 0
0 0 0 0 0 0 0 0 0 0