15 12 23
0 0 0 0 G 0 0 0 0 0 0 0
0 -1 -1 2 0 0 0 -1 -1 0 0 0
0 0 0 -1 0 0 0 0 -1 -1 0 0
-1 -1 0 0 0 0 0 7 -1 0 0 0
0 0 0 0 0 0 -1 -1 -1 0 0 -1
0 -1 -1 0 0 -1 0 0 0 0 0 -1
-1 -1 0 0 5 0 0 0 0 0 0 -1
0 0 0 0 0 0 0 -1 0 0 0 -1
0 0 0 -1 10 0 0 -1 0 0 0 -1
0 0 0 0 0 0 0 0 -1 0 0 0
-1 -1 0 0 -1 0 0 0 0 0 0 0
0 0 0 4 0 0 0 0 S 0 0 0
-1 -1 0 0 0 0 0 0 0 8 0 0
0 0 0 0 -1 -1 -1 0 0 0 0 0
-1 -1 0 0 0 0 0 0 0 0 0 0