10 10 22 11
0 0 -1 0 0 -1 0 0 0 0
0 -1 S1 0 0 -1 0 0 -1 0
0 -1 0 0 1 0 0 0 -1 0
0 0 0 0 0 7 0 F1 -1 0
0 4 0 F2 -1 0 11 0 -1 0
0 -1 0 0 0 -1 0 7 0 0
0 0 0 -1 -1 -1 0 0 0 0
0 0 0 -1 0 0 0 0 -1 0
0 -1 -1 -1 0 0 G1 0 0 0
0 0 0 0 0 0 0 0 0 0