15 12 24 15
0 0 0 0 G 0 0 0 0 0 0 0
0 -1 -1 2 0 0 0 -1 -1 0 0 0
0 0 0 -1 0 0 0 0 -1 -1 0 0
-1 -1 0 0 0 0 0 7 0 0 9 0
0 0 0 0 0 0 -1 -1 -1 0 0 -1
0 -1 -1 0 0 -1 0 0 0 -1 0 -1
-1 -1 0 0 8 0 0 0 -1 0 0 -1
0 0 0 0 0 -1 0 -1 0 0 0 -1
0 0 0 -1 F2 0 0 -1 0 0 0 -1
0 0 0 0 0 0 0 -1 -1 0 0 0
-1 -1 0 0 -1 0 0 0 0 0 0 0
0 0 5 4 3 2 1 2 3 4 5 0
-1 -1 0 0 0 0 0 0 0 8 0 0
0 0 0 0 -1 -1 -1 0 0 0 0 0
-1 -1 0 0 0 0 0 0 0 S 0 0