15 12 30 17
0 0 0 0 G 0 0 0 0 0 0 0
0 -1 -1 0 0 0 0 -1 -1 0 0 0
0 0 0 -1 0 9 0 0 -1 -1 0 0
-1 -1 0 0 0 0 0 7 0 0 0 0
0 0 0 0 0 0 -1 -1 -1 0 0 -1
0 -1 -1 0 0 -1 0 0 0 0 0 -1
-1 -1 0 0 8 0 0 0 -1 0 0 -1
0 0 0 0 0 -1 0 -1 0 0 -1 -1
0 0 F1 -1 F2 0 0 -1 0 0 0 -1
0 0 0 0 0 0 0 -1 -1 0 0 0
-1 -1 0 0 -1 0 0 0 0 0 -1 0
0 0 -1 4 -1 2 6 -1 -1 0 0 0
-1 -1 0 0 0 0 0 0 0 8 0 0
0 0 0 0 -1 -1 -1 0 0 0 0 0
-1 -1 0 0 0 0 0 0 0 S 0 0