11 14 37 26
S 0 0 0 0 -1 -1 -1 -1 0 0 0 G 0
0 -1 -1 -1 -1 0 0 0 -1 -1 -1 7 0 0
0 0 0 2 -1 0 0 0 0 0 -1 0 0 0
0 -1 -1 0 -1 -1 -1 0 6 0 -1 0 0 0
0 0 0 0 0 5 -1 -1 0 0 -1 0 -1 0
0 -1 -1 -1 0 0 0 0 0 0 -1 0 0 0
0 0 0 -1 -1 -1 -1 -1 0 0 -1 0 -1 0
0 0 -1 -1 0 0 0 -1 -1 0 -1 0 -1 0
0 0 0 0 0 -1 0 -1 0 0 -1 0 -1 0
0 -1 -1 -1 0 -1 0 F1 0 0 -1 0 -1 0
0 0 1 0 0 -1 -1 0 0 0 0 0 -1 0