10 10 21 10
0 0 0 0 0 0 9 0 -1 0
0 -1 -1 0 0 -1 0 0 -1 0
0 0 0 -1 S 0 0 0 -1 0
0 0 -1 0 0 0 -1 0 -1 0
2 0 0 0 -1 0 0 0 12 0
0 -1 0 0 0 -1 0 9 0 0
0 0 0 -1 -1 0 5 0 0 0
0 0 0 0 F1 0 -1 -1 -1 0
0 -1 -1 -1 0 0 0 0 0 0
0 0 0 -1 0 0 0 7 G 0